The grammar: 
START SYMBOL: program	Not used
TERMINALS:
IDENTIFIER	TYPENAME	SCOPED_TYPENAME	SCSPEC	TYPESPEC	TYPE_QUAL	CONSTANT	STRING	ELLIPSIS	SIZEOF	ENUM	IF	ELSE	WHILE	DO	FOR	SWITCH	CASE	DEFAULT	BREAK	CONTINUE	RETURN	GOTO	ASM_KEYWORD	GCC_ASM_KEYWORD	TYPEOF	ALIGNOF	HEADOF	CLASSOF	ATTRIBUTE	EXTENSION	LABEL	AGGR	VISSPEC	DELETE	NEW	OVERLOAD	THIS	OPERATOR	LEFT_RIGHT	TEMPLATE	TYPEID	DYNAMIC_CAST	SCOPE	START_DECLARATOR	EMPTY	Not used	TYPENAME_COLON	'{'	','	ASSIGN	'='	'?'	':'	RANGE	OROR	ANDAND	'|'	'^'	'&'	MIN_MAX	EQCOMPARE	ARITHCOMPARE	'<'	'>'	LSHIFT	RSHIFT	'+'	'-'	'*'	'/'	'%'	UNARY	Not used	PLUSPLUS	MINUSMINUS	HYPERUNARY	Not used	PAREN_STAR_PAREN	POINTSAT	POINTSAT_STAR	'.'	DOT_STAR	'('	'['	RAISE	RAISES	RERAISE	TRY	EXCEPT	CATCH	THROW	ANSI_TRY	ANSI_THROW	TYPENAME_ELLIPSIS	PTYPENAME	PRE_PARSED_FUNCTION_DECL	EXTERN_LANG_STRING	ALL	PRE_PARSED_CLASS_DECL	TYPENAME_DEFN	IDENTIFIER_DEFN	PTYPENAME_DEFN	END_OF_SAVED_INPUT	Not used	error	')'	';'	'}'	'~'	'!'	']'	
NON-TERMINALS:
0: program	-> /* Empty */ | extdefs
1: extdefs	-> extdef | extdefs extdef
2: extdef	-> fndef | datadef | template_def | overloaddef | asm_keyword '(' string ')' ';' | extern_lang_string '{' extdefs '}' | extern_lang_string '{' '}' | extern_lang_string .hush_warning fndef .warning_ok | extern_lang_string .hush_warning datadef .warning_ok
3: .hush_warning	-> /* Empty */
4: .warning_ok	-> /* Empty */
5: asm_keyword	-> ASM_KEYWORD | GCC_ASM_KEYWORD
6: fndef	-> fn.def1 base_init compstmt_or_error | fn.def1 return_init base_init compstmt_or_error | fn.def1 nodecls compstmt_or_error | fn.def1 return_init ';' nodecls compstmt_or_error | fn.def1 return_init nodecls compstmt_or_error | typed_declspecs declarator error | declmods notype_declarator error | notype_declarator error
7: datadef	-> notype_initdecls ';' | declmods notype_initdecls ';' | declmods declarator ';' | typed_declspecs initdecls ';' | typed_declspecs declarator ';' | declmods ';' | typed_declspecs ';' | error ';' | error '}' | ';'
8: template_def	-> template_header named_class_head_sans_basetype '{' '{' ';' | template_header named_class_head_sans_basetype_defn '{' '{' ';' | template_header named_class_head_sans_basetype ':' ';' | template_header named_class_head_sans_basetype_defn ':' ';' | template_header named_class_head_sans_basetype ';' | template_header named_class_head_sans_basetype_defn ';' | template_header notype_declarator maybe_raises maybeasm maybe_attribute fn_tmpl_end | template_header typed_declspecs declarator maybe_raises maybeasm maybe_attribute fn_tmpl_end | template_header declmods declarator fn_tmpl_end | template_header error '}' | template_header error ';'
9: overloaddef	-> OVERLOAD ov_identifiers ';'
10: string	-> STRING | string STRING
11: extern_lang_string	-> EXTERN_LANG_STRING
12: template_header	-> TEMPLATE '<' template_parm_list '>'
13: template_parm_list	-> template_parm | template_parm_list ',' template_parm
14: template_parm	-> aggr identifier | aggr identifier_defn ':' base_class.1 | aggr TYPENAME_COLON base_class.1 | parm
15: aggr	-> AGGR | aggr SCSPEC | aggr TYPESPEC | aggr TYPE_QUAL | aggr AGGR
16: identifier	-> IDENTIFIER | TYPENAME | PTYPENAME
17: identifier_defn	-> IDENTIFIER_DEFN | TYPENAME_DEFN | PTYPENAME_DEFN
18: base_class.1	-> template_type_name tmpl.2 template_instantiation | identifier
19: parm	-> typed_declspecs dont_see_typename abs_or_notype_decl | declmods dont_see_typename abs_or_notype_decl
20: ov_identifiers	-> IDENTIFIER | ov_identifiers ',' IDENTIFIER
21: named_class_head_sans_basetype	-> aggr identifier | aggr template_type_name | aggr TYPENAME_COLON | aggr template_type_name '{' '{' | aggr template_type_name ':'
22: named_class_head_sans_basetype_defn	-> aggr identifier_defn
23: notype_declarator	-> notype_declarator '(' nonnull_exprlist ')' type_quals | notype_declarator '(' parmlist ')' type_quals | notype_declarator LEFT_RIGHT type_quals | notype_declarator '(' error ')' type_quals | '(' notype_declarator ')' | '*' type_quals notype_declarator | '&' type_quals notype_declarator | notype_declarator '[' nonmomentary_expr ']' | notype_declarator '[' ']' | IDENTIFIER | operator_name | '~' TYPENAME | '~' IDENTIFIER | '~' PTYPENAME | id_scope see_typename notype_declarator | id_scope see_typename TYPENAME | id_scope see_typename TYPENAME '(' nonnull_exprlist ')' type_quals | id_scope see_typename TYPENAME '(' parmlist ')' type_quals | id_scope see_typename TYPENAME LEFT_RIGHT type_quals | id_scope see_typename TYPENAME '(' error ')' type_quals | id_scope see_typename PTYPENAME | id_scope see_typename PTYPENAME '(' nonnull_exprlist ')' type_quals | id_scope see_typename PTYPENAME '(' parmlist ')' type_quals | id_scope see_typename PTYPENAME LEFT_RIGHT type_quals | id_scope see_typename PTYPENAME '(' error ')' type_quals | SCOPE see_typename notype_declarator
24: maybe_raises	-> /* Empty */ | RAISES raise_identifiers | ANSI_THROW '(' ansi_raise_identifiers ')'
25: maybeasm	-> /* Empty */ | asm_keyword '(' string ')'
26: maybe_attribute	-> /* Empty */ | ATTRIBUTE '(' '(' attribute_list ')' ')'
27: fn_tmpl_end	-> '{' '{' | ':' | ';' | '=' | RETURN
28: typed_declspecs	-> typespec | declmods typespec | typespec reserved_declspecs | declmods typespec reserved_declspecs
29: declarator	-> after_type_declarator | notype_declarator | START_DECLARATOR after_type_declarator | START_DECLARATOR notype_declarator
30: declmods	-> TYPE_QUAL | SCSPEC | declmods TYPE_QUAL | declmods SCSPEC
31: notype_initdecls	-> notype_initdcl0 | notype_initdecls ',' initdcl
32: initdecls	-> initdcl0 | initdecls ',' initdcl
33: fn.def1	-> typed_declspecs declarator maybe_raises | declmods notype_declarator maybe_raises | notype_declarator maybe_raises | TYPENAME '(' parmlist ')' type_quals maybe_raises | scoped_typename '(' parmlist ')' type_quals maybe_raises | TYPENAME LEFT_RIGHT type_quals maybe_raises | scoped_typename LEFT_RIGHT type_quals maybe_raises | PRE_PARSED_FUNCTION_DECL
34: base_init	-> ':' .set_base_init member_init_list
35: compstmt_or_error	-> compstmt | error compstmt
36: return_init	-> return_id | return_id '=' init | return_id '(' nonnull_exprlist ')' | return_id LEFT_RIGHT
37: nodecls	-> /* Empty */
38: parmlist	-> /* Empty */ | parms | parms ',' ELLIPSIS | parms ELLIPSIS | ELLIPSIS | TYPENAME_ELLIPSIS | parms TYPENAME_ELLIPSIS | parms ':'
39: type_quals	-> /* Empty */ | type_quals TYPE_QUAL
40: scoped_typename	-> SCOPED_TYPENAME | template_type SCOPED_TYPENAME
41: fn.def2	-> typed_declspecs '(' parmlist ')' type_quals maybe_raises | typed_declspecs LEFT_RIGHT type_quals maybe_raises | typed_declspecs declarator maybe_raises | declmods '(' parmlist ')' type_quals maybe_raises | declmods LEFT_RIGHT type_quals maybe_raises | declmods declarator maybe_raises | notype_declarator maybe_raises
42: return_id	-> RETURN IDENTIFIER
43: init	-> expr_no_commas | '{' '}' | '{' initlist '}' | '{' initlist ',' '}' | error
44: nonnull_exprlist	-> expr_no_commas | nonnull_exprlist ',' expr_no_commas | nonnull_exprlist ',' error
45: .set_base_init	-> /* Empty */
46: member_init_list	-> /* Empty */ | member_init | member_init_list ',' member_init | member_init_list error
47: member_init	-> '(' nonnull_exprlist ')' | LEFT_RIGHT | identifier '(' nonnull_exprlist ')' | identifier LEFT_RIGHT | template_type_name '(' nonnull_exprlist ')' | template_type_name LEFT_RIGHT | scoped_typename '(' nonnull_exprlist ')' | scoped_typename LEFT_RIGHT | id_scope identifier '(' nonnull_exprlist ')' | id_scope identifier LEFT_RIGHT
48: template_type_name	-> PTYPENAME '<' template_arg_list '>' | TYPENAME '<' template_arg_list '>'
49: id_scope	-> typename_scope | IDENTIFIER SCOPE | template_type SCOPE
50: identifier_or_opname	-> IDENTIFIER | TYPENAME | PTYPENAME | '~' identifier | operator_name
51: operator_name	-> OPERATOR '*' | OPERATOR '/' | OPERATOR '%' | OPERATOR '+' | OPERATOR '-' | OPERATOR '&' | OPERATOR '|' | OPERATOR '^' | OPERATOR '~' | OPERATOR ',' | OPERATOR ARITHCOMPARE | OPERATOR '<' | OPERATOR '>' | OPERATOR EQCOMPARE | OPERATOR ASSIGN | OPERATOR '=' | OPERATOR LSHIFT | OPERATOR RSHIFT | OPERATOR PLUSPLUS | OPERATOR MINUSMINUS | OPERATOR ANDAND | OPERATOR OROR | OPERATOR '!' | OPERATOR '?' ':' | OPERATOR MIN_MAX | OPERATOR POINTSAT | OPERATOR POINTSAT_STAR | OPERATOR LEFT_RIGHT | OPERATOR '[' ']' | OPERATOR NEW | OPERATOR DELETE | OPERATOR typed_typespecs absdcl | OPERATOR error
52: template_type	-> template_type_name tmpl.1 template_instantiation
53: tmpl.1	-> '{' '{' | ':' | /* Empty */
54: template_instantiation	-> /* Empty */ | template_instantiate_once
55: template_arg_list	-> template_arg | template_arg_list ',' template_arg
56: tmpl.2	-> /* Empty */
57: template_arg	-> typename | expr_no_commas
58: typename	-> typed_typespecs absdcl | nonempty_type_quals absdcl
59: expr_no_commas	-> cast_expr | expr_no_commas '+' expr_no_commas | expr_no_commas '-' expr_no_commas | expr_no_commas '*' expr_no_commas | expr_no_commas '/' expr_no_commas | expr_no_commas '%' expr_no_commas | expr_no_commas LSHIFT expr_no_commas | expr_no_commas RSHIFT expr_no_commas | expr_no_commas ARITHCOMPARE expr_no_commas | expr_no_commas '<' expr_no_commas | expr_no_commas '>' expr_no_commas | expr_no_commas EQCOMPARE expr_no_commas | expr_no_commas MIN_MAX expr_no_commas | expr_no_commas '&' expr_no_commas | expr_no_commas '|' expr_no_commas | expr_no_commas '^' expr_no_commas | expr_no_commas ANDAND expr_no_commas | expr_no_commas OROR expr_no_commas | expr_no_commas '?' xexpr ':' expr_no_commas | expr_no_commas '=' expr_no_commas | expr_no_commas ASSIGN expr_no_commas | primary DOT_STAR expr_no_commas | object_star expr_no_commas
60: template_instantiate_once	-> PRE_PARSED_CLASS_DECL maybe_base_class_list left_curly opt.component_decl_list '}'
61: maybe_base_class_list	-> /* Empty */ | ':' | ':' base_class_list
62: left_curly	-> '{'
63: opt.component_decl_list	-> /* Empty */ | component_decl_list | opt.component_decl_list VISSPEC ':' component_decl_list | opt.component_decl_list VISSPEC ':'
64: template_instantiate_some	-> /* Empty */ | template_instantiate_once template_instantiate_some
65: unop	-> '-' | '+' | PLUSPLUS | MINUSMINUS | '!'
66: expr	-> nonnull_exprlist | expr_no_commas
67: paren_expr_or_null	-> LEFT_RIGHT | '(' expr ')'
68: paren_cond_or_null	-> LEFT_RIGHT | '(' condition ')'
69: condition	-> typed_typespecs declarator maybe_raises maybeasm maybe_attribute '=' init | expr
70: xcond	-> /* Empty */ | condition | error
71: typed_typespecs	-> typespec | nonempty_type_quals typespec | typespec reserved_typespecquals | nonempty_type_quals typespec reserved_typespecquals
72: .kindof_pushlevel	-> /* Empty */
73: partially_scoped_stmt	-> '{' .kindof_pushlevel '}' | '{' .kindof_pushlevel maybe_label_decls stmts '}' | '{' .kindof_pushlevel maybe_label_decls error '}' | .kindof_pushlevel simple_stmt
74: maybe_label_decls	-> /* Empty */ | label_decls
75: stmts	-> stmt | errstmt | stmts stmt | stmts errstmt
76: simple_stmt	-> decl | expr ';' | simple_if ELSE partially_scoped_stmt | simple_if | WHILE .pushlevel paren_cond_or_null already_scoped_stmt | DO implicitly_scoped_stmt WHILE paren_expr_or_null ';' | forhead.1 .pushlevel xcond ';' xexpr ')' already_scoped_stmt | forhead.2 .pushlevel xcond ';' xexpr ')' already_scoped_stmt | SWITCH .pushlevel '(' condition ')' partially_scoped_stmt | CASE expr_no_commas ':' stmt | CASE expr_no_commas RANGE expr_no_commas ':' stmt | DEFAULT ':' stmt | BREAK ';' | CONTINUE ';' | RETURN ';' | RETURN expr ';' | asm_keyword maybe_type_qual '(' string ')' ';' | asm_keyword maybe_type_qual '(' string ':' asm_operands ')' ';' | asm_keyword maybe_type_qual '(' string ':' asm_operands ':' asm_operands ')' ';' | asm_keyword maybe_type_qual '(' string ':' asm_operands ':' asm_operands ':' asm_clobbers ')' ';' | GOTO '*' expr ';' | GOTO identifier ';' | label_colon stmt | label_colon '}' '}' | ';' | ANSI_THROW ';' | ANSI_THROW expr ';' | THROW raise_identifier '(' nonnull_exprlist ')' ';' | THROW raise_identifier LEFT_RIGHT ';' | RAISE raise_identifier '(' nonnull_exprlist ')' ';' | RAISE raise_identifier LEFT_RIGHT ';' | RAISE identifier ';' | try EXCEPT identifier '{' except_stmts '}' | try error | ansi_try ansi_dummy ansi_dummy ansi_except_stmts | try RERAISE raise_identifiers | try
77: already_scoped_stmt	-> '{' '}' | '{' maybe_label_decls stmts '}' | '{' maybe_label_decls error '}' | simple_stmt
78: unary_expr	-> primary | EXTENSION cast_expr | '*' cast_expr | '&' cast_expr | '~' cast_expr | unop cast_expr | ANDAND identifier | SIZEOF unary_expr | SIZEOF '(' typename ')' | ALIGNOF unary_expr | ALIGNOF '(' typename ')' | .scope new typename | .scope new '(' nonnull_exprlist ')' typename | .scope new typespec '(' nonnull_exprlist ')' | .scope new typespec '(' typespec ')' | .scope new '(' nonnull_exprlist ')' typespec '(' nonnull_exprlist ')' | .scope new typespec LEFT_RIGHT | .scope new '(' nonnull_exprlist ')' typespec LEFT_RIGHT | .scope new typename '=' init | .scope new '(' nonnull_exprlist ')' typename '=' init | .scope new '(' typed_typespecs absdcl ')' '[' nonmomentary_expr ']' | .scope new '(' nonempty_type_quals absdcl ')' '[' nonmomentary_expr ']' | .scope new '(' typed_typespecs absdcl ')' | .scope new '(' nonnull_exprlist ')' '(' typed_typespecs absdcl ')' | .scope new '(' nonempty_type_quals absdcl ')' | .scope new '(' nonnull_exprlist ')' '(' nonempty_type_quals absdcl ')' | .scope new TYPENAME_COLON | .scope new '(' nonnull_exprlist ')' TYPENAME_COLON | delete cast_expr | delete '[' ']' cast_expr | delete '[' expr ']' cast_expr
79: primary	-> IDENTIFIER | operator_name | CONSTANT | string | '(' expr ')' | '(' error ')' | '(' compstmt ')' | primary '(' nonnull_exprlist ')' template_instantiate_some | primary LEFT_RIGHT | primary '[' expr ']' | object identifier_or_opname | object id_scope identifier_or_opname | primary PLUSPLUS | primary MINUSMINUS | THIS | TYPE_QUAL '(' nonnull_exprlist ')' | typespec '(' nonnull_exprlist ')' | typespec LEFT_RIGHT | DYNAMIC_CAST '<' typename '>' '(' expr ')' | TYPEID '(' expr ')' | TYPEID '(' typename ')' | SCOPE typespec '(' nonnull_exprlist ')' | SCOPE typespec LEFT_RIGHT | SCOPE IDENTIFIER | SCOPE operator_name | id_scope identifier_or_opname | id_scope identifier_or_opname '(' nonnull_exprlist ')' | id_scope identifier_or_opname LEFT_RIGHT | object identifier_or_opname '(' nonnull_exprlist ')' | object identifier_or_opname LEFT_RIGHT | object id_scope identifier_or_opname '(' nonnull_exprlist ')' | object id_scope identifier_or_opname LEFT_RIGHT | object '~' TYPESPEC LEFT_RIGHT | object TYPESPEC SCOPE '~' TYPESPEC LEFT_RIGHT
80: cast_expr	-> unary_expr | '(' typename ')' expr_no_commas | '(' typename ')' '{' initlist maybecomma '}' | HEADOF '(' expr ')' | CLASSOF '(' expr ')' | CLASSOF '(' TYPENAME ')'
81: .scope	-> /* Empty */ | SCOPE
82: new	-> NEW | NEW '{' nonnull_exprlist '}'
83: typespec	-> structsp | TYPESPEC | TYPENAME | scoped_typename | TYPEOF '(' expr ')' | TYPEOF '(' typename ')' | template_type
84: absdcl	-> /* Empty */ | absdcl1 | START_DECLARATOR absdcl1
85: nonmomentary_expr	-> expr
86: nonempty_type_quals	-> TYPE_QUAL | nonempty_type_quals TYPE_QUAL
87: delete	-> DELETE | SCOPE delete
88: initlist	-> init | initlist ',' init | '[' expr_no_commas ']' init | initlist ',' CASE expr_no_commas ':' init | identifier ':' init | initlist ',' identifier ':' init
89: maybecomma	-> /* Empty */ | ','
90: xexpr	-> /* Empty */ | expr | error
91: object_star	-> primary POINTSAT_STAR
92: compstmt	-> '{' .pushlevel '}' | '{' .pushlevel maybe_label_decls stmts '}' | '{' .pushlevel maybe_label_decls error '}'
93: object	-> primary '.' | primary POINTSAT
94: decl	-> typed_declspecs initdecls ';' | typed_declspecs declarator ';' | declmods notype_initdecls ';' | declmods declarator ';' | typed_declspecs ';' | declmods ';'
95: after_type_declarator	-> after_type_declarator '(' nonnull_exprlist ')' type_quals | after_type_declarator '(' parmlist ')' type_quals | after_type_declarator LEFT_RIGHT type_quals | after_type_declarator '(' error ')' type_quals | after_type_declarator '[' nonmomentary_expr ']' | after_type_declarator '[' ']' | '(' after_type_declarator_no_typename ')' | '(' '*' type_quals after_type_declarator ')' | PAREN_STAR_PAREN | after_type_member_declarator | '(' '&' type_quals after_type_declarator ')' | '*' type_quals after_type_declarator | '&' type_quals after_type_declarator | TYPENAME
96: reserved_declspecs	-> typespecqual_reserved | SCSPEC | reserved_declspecs typespecqual_reserved | reserved_declspecs SCSPEC
97: typespecqual_reserved	-> TYPESPEC | TYPE_QUAL | structsp
98: reserved_typespecquals	-> typespecqual_reserved | reserved_typespecquals typespecqual_reserved
99: structsp	-> ENUM identifier '{' enumlist maybecomma_warn '}' | ENUM identifier '{' '}' | ENUM '{' enumlist maybecomma_warn '}' | ENUM '{' '}' | ENUM identifier | class_head left_curly opt.component_decl_list '}' | class_head
100: initdcl0	-> declarator maybe_raises maybeasm maybe_attribute '=' init | declarator maybe_raises maybeasm maybe_attribute
101: initdcl	-> declarator maybe_raises maybeasm maybe_attribute '=' init | declarator maybe_raises maybeasm maybe_attribute
102: notype_initdcl0	-> notype_declarator maybe_raises maybeasm maybe_attribute '=' init | notype_declarator maybe_raises maybeasm maybe_attribute
103: attribute_list	-> attrib | attribute_list ',' attrib
104: attrib	-> IDENTIFIER | IDENTIFIER '(' CONSTANT ')' | IDENTIFIER '(' IDENTIFIER ',' CONSTANT ',' CONSTANT ')'
105: identifiers_or_typenames	-> identifier | identifiers_or_typenames ',' identifier
106: enumlist	-> enumerator | enumlist ',' enumerator
107: maybecomma_warn	-> /* Empty */ | ','
108: class_head	-> unnamed_class_head | named_class_head
109: named_class_head	-> named_class_head_sans_basetype maybe_base_class_list | named_class_head_sans_basetype_defn maybe_base_class_list
110: unnamed_class_head	-> aggr '{' '{'
111: base_class_list	-> base_class | base_class_list ',' base_class
112: base_class	-> base_class.1 | scoped_base_class | base_class_visibility_list base_class.1 | base_class_visibility_list scoped_base_class
113: scoped_base_class	-> base_class.1 SCOPED_TYPENAME
114: base_class_visibility_list	-> VISSPEC | SCSPEC | base_class_visibility_list VISSPEC | base_class_visibility_list SCSPEC
115: component_decl_list	-> component_decl | component_decl_list component_decl | component_decl_list ';'
116: component_decl	-> typed_declspecs components ';' | typed_declspecs '(' parmlist ')' ';' | typed_declspecs '(' parmlist ')' '}' '}' | typed_declspecs LEFT_RIGHT ';' | typed_declspecs LEFT_RIGHT '}' '}' | declmods components ';' | declmods declarator ';' | declmods components '}' '}' | declmods '(' parmlist ')' ';' | declmods '(' parmlist ')' '}' '}' | declmods LEFT_RIGHT ';' | declmods LEFT_RIGHT '}' '}' | ':' expr_no_commas ';' | ':' expr_no_commas '}' '}' | error | fn.def2 ':' | fn.def2 '{' | notype_declarator maybe_raises ';' | notype_declarator maybe_raises '}' '}'
117: components	-> /* Empty */ | component_declarator0 | components ',' component_declarator
118: component_declarator0	-> declarator maybe_raises maybeasm maybe_attribute | declarator maybe_raises maybeasm maybe_attribute '=' init | IDENTIFIER ':' expr_no_commas maybe_attribute | TYPENAME ':' expr_no_commas maybe_attribute | ':' expr_no_commas maybe_attribute
119: component_declarator	-> declarator maybe_raises maybeasm maybe_attribute | declarator maybe_raises maybeasm maybe_attribute '=' init | IDENTIFIER ':' expr_no_commas maybe_attribute | TYPENAME ':' expr_no_commas maybe_attribute | ':' expr_no_commas maybe_attribute
120: enumerator	-> identifier | identifier '=' expr_no_commas
121: absdcl1	-> '(' absdcl1 ')' | '*' type_quals absdcl1 | '*' type_quals | PAREN_STAR_PAREN | '(' abs_member_declarator ')' | '&' type_quals absdcl1 | '&' type_quals | absdcl1 '(' parmlist ')' type_quals | absdcl1 LEFT_RIGHT type_quals | absdcl1 '[' nonmomentary_expr ']' | absdcl1 '[' ']' | '(' parmlist ')' type_quals | LEFT_RIGHT type_quals | '[' nonmomentary_expr ']' | '[' ']'
122: after_type_declarator_no_typename	-> after_type_declarator_no_typename '(' nonnull_exprlist ')' type_quals | after_type_declarator_no_typename '(' parmlist ')' type_quals | after_type_declarator_no_typename LEFT_RIGHT type_quals | after_type_declarator_no_typename '(' error ')' type_quals | after_type_declarator_no_typename '[' nonmomentary_expr ']' | after_type_declarator_no_typename '[' ']' | '(' after_type_declarator_no_typename ')' | PAREN_STAR_PAREN | after_type_member_declarator | '*' type_quals after_type_declarator | '&' type_quals after_type_declarator
123: after_type_member_declarator	-> id_scope see_typename '*' type_quals after_type_declarator | id_scope see_typename '&' type_quals after_type_declarator
124: see_typename	-> type_quals
125: typename_scope	-> TYPENAME SCOPE
126: abs_member_declarator	-> id_scope see_typename '*' type_quals | id_scope see_typename '*' type_quals absdcl1 | id_scope see_typename '&' type_quals | id_scope see_typename '&' type_quals absdcl1
127: stmt	-> compstmt | simple_stmt
128: errstmt	-> error ';'
129: .pushlevel	-> /* Empty */
130: label_decls	-> label_decl | label_decls label_decl
131: label_decl	-> LABEL identifiers_or_typenames ';'
132: simple_if	-> IF .pushlevel paren_cond_or_null partially_scoped_stmt
133: implicitly_scoped_stmt	-> compstmt | .pushlevel simple_stmt
134: forhead.1	-> FOR '(' ';' | FOR '(' expr ';' | FOR '(' '{' '}'
135: forhead.2	-> FOR '(' decl | FOR '(' error ';' | FOR '(' '{' .pushlevel stmts '}' | FOR '(' '{' .pushlevel error '}'
136: maybe_type_qual	-> /* Empty */ | TYPE_QUAL
137: asm_operands	-> /* Empty */ | nonnull_asm_operands
138: asm_clobbers	-> STRING | asm_clobbers ',' STRING
139: label_colon	-> IDENTIFIER ':' | PTYPENAME ':' | TYPENAME_COLON
140: raise_identifier	-> ALL | IDENTIFIER | TYPENAME | SCOPE IDENTIFIER | SCOPE TYPENAME | id_scope IDENTIFIER | scoped_typename
141: try	-> try_head '}' | try_head stmts '}' | try_head error '}'
142: except_stmts	-> /* Empty */ | except_stmts raise_identifier compstmt | except_stmts DEFAULT compstmt
143: ansi_try	-> ansi_try_head '}' | ansi_try_head stmts '}' | ansi_try_head error '}'
144: ansi_dummy	-> /* Empty */
145: ansi_except_stmts	-> /* Empty */ | ansi_except_stmts CATCH '(' typename optional_identifier ')' compstmt
146: raise_identifiers	-> raise_identifier | raise_identifiers ',' raise_identifier
147: try_head	-> TRY '{' .pushlevel
148: ansi_try_head	-> ANSI_TRY '{' .pushlevel
149: optional_identifier	-> /* Empty */ | identifier
150: nonnull_asm_operands	-> asm_operand | nonnull_asm_operands ',' asm_operand
151: asm_operand	-> STRING '(' expr ')'
152: parms	-> parm | parm '=' init | parms ',' parm | parms ',' parm '=' init | parms ',' bad_parm | parms ',' bad_parm '=' init
153: bad_parm	-> abs_or_notype_decl
154: dont_see_typename	-> /* Empty */
155: abs_or_notype_decl	-> absdcl | notype_declarator | START_DECLARATOR notype_declarator
156: ansi_raise_identifiers	-> ansi_raise_identifier | ansi_raise_identifiers ',' ansi_raise_identifier
157: ansi_raise_identifier	-> typename
>>> There are 108 terminals and 158 non-terminals 
>>> Total McCabe complexity is: 512
McCabe Metrics:
   1   1   8   0   0   1   7   9  10   0   1   0   0   1   3   4   2   2   1   1
   1   4   0  25   2   1   1   4   3   3   3   1   1   7   0   1   3   0   7   1
   1   6   0   4   2   0   3   9   1   2   4  32   0   2   1   1   0   1   1  22
   0   2   0   3   1   4   1   1   1   1   2   3   0   3   1   3  36   3  30  33
   5   1   1   6   2   0   1   1   5   1   2   0   2   1   5  13   3   2   1   6
   1   1   1   1   2   1   1   1   1   1   0   1   3   0   3   2  18   2   4   4
   1  14  10   1   0   0   3   1   0   0   1   0   0   1   2   3   1   1   1   2
   6   2   2   2   0   1   1   0   0   1   1   0   5   0   0   2   1   0
>>> Total Halstead volume is: 670386
>>> Average RHS Size is: 11.5316
GRAMMATICAL LEVELS:
DERIVES-IN-ONE RELATION
  0:  *                                                                                                                                                            
  1:  **                                                                                                                                                           
  2:  * *********                                                                                                                                                  
  3:                                                                                                                                                               
  4:                                                                                                                                                               
  5:                                                                                                                                                               
  6:                        *    ***  *****                                                                                                                        
  7:                             *****                                                                                                                             
  8:             *        **********                                                                                                                               
  9:                     *                                                                                                                                         
 10:           *                                                                                                                                                   
 11:                                                                                                                                                               
 12:              *                                                                                                                                                
 13:              **                                                                                                                                               
 14:                *****                                                                                                                                          
 15:                *                                                                                                                                              
 16:                                                                                                                                                               
 17:                                                                                                                                                               
 18:                 *                               *     * *                                                                                                     
 19:                             * *                                                                                                                           **  
 20:                     *                                                                                                                                         
 21:                **                               *                                                                                                             
 22:                * *                                                                                                                                            
 23:                        *              **    *    * *                                 *                                      *                                 
 24:                                                                                                                                                   *         * 
 25:      *    *                                                                                                                                                   
 26:                                                                                                        *                                                      
 27:                                                                                                                                                               
 28:                               *                                                    *            *                                                             
 29:                        *                                                                       *                                                              
 30:                               *                                                                                                                               
 31:                                *                                                                     **                                                       
 32:                                 *                                                                   **                                                        
 33:                        **   ***       ***                                                                                                                     
 34:                                              **                                                                                                               
 35:                                                                                             *                                                                 
 36:                                           ***                                                                                                                 
 37:                                                                                                                                                               
 38:                                                                                                                                                         *     
 39:                                        *                                                                                                                      
 40:                                                     *                                                                                                         
 41:                        **   ***       **                                                                                                                      
 42:                                                                                                                                                               
 43:                                                            *                            *                                                                     
 44:                                             *              *                                                                                                  
 45:                                                                                                                                                               
 46:                                               **                                                                                                              
 47:                 *                       *   *   **                                                                                                            
 48:                                                        *                                                                                                      
 49:                                                     *                                                                        *                                
 50:                 *                                  *                                                                                                          
 51:                                                                        *            *                                                                         
 52:                                                 *    **                                                                                                       
 53:                                                                                                                                                               
 54:                                                             *                                                                                                 
 55:                                                        * *                                                                                                    
 56:                                                                                                                                                               
 57:                                                           **                                                                                                  
 58:                                                                        *            * *                                                                       
 59:                                                            *                   **         **                                                                  
 60:                                                              ***                                                                                              
 61:                                                                                                                *                                              
 62:                                                                                                                                                               
 63:                                                                *                                                   *                                          
 64:                                                             *   *                                                                                             
 65:                                                                                                                                                               
 66:                                             *              *                                                                                                  
 67:                                                                   *                                                                                           
 68:                                                                      *                                                                                        
 69:                         ***  *             *                      *    *                                                                                      
 70:                                                                      *                                                                                        
 71:                                                                                    *  *           *                                                           
 72:                                                                                                                                                               
 73:                                                                         * ***                                                                                 
 74:                                                                                                                                   *                           
 75:                                                                            *                                                   **                             
 76:      *    *     *                           *              *      *****  *   *            *   *                                * *  ***************           
 77:                                                                           ***                                                                                 
 78:                 *                          **             *      **    *      **********                                                                      
 79:           *                                 *    ***      *     * *            *   *        **                                                                
 80:                                                           **      *           *         **                                                                    
 81:                                                                                                                                                               
 82:                                             *                                                                                                                 
 83:                                         *           *     *       *                                *                                                          
 84:                                                                                                                          *                                    
 85:                                                                   *                                                                                           
 86:                                                                                       *                                                                       
 87:                                                                                        *                                                                      
 88:                 *                          *               *                            *                                                                     
 89:                                                                                                                                                               
 90:                                                                   *                                                                                           
 91:                                                                                *                                                                              
 92:                                                                           **                                                     *                            
 93:                                                                                *                                                                              
 94:                             *****                                                                                                                             
 95:                                       **    *                                        *         *                          **                                  
 96:                                                                                                 **                                                            
 97:                                                                                                    *                                                          
 98:                                                                                                  **                                                           
 99:                 *                                             **                                          ***                                                 
100:                         ***  *             *                                                                                                                  
101:                         ***  *             *                                                                                                                  
102:                        ****                *                                                                                                                  
103:                                                                                                        **                                                     
104:                                                                                                                                                               
105:                 *                                                                                        *                                                    
106:                                                                                                           *             *                                     
107:                                                                                                                                                               
108:                                                                                                              **                                               
109:                      **                                      *                                                                                                
110:                *                                                                                                                                              
111:                                                                                                                **                                             
112:                   *                                                                                              **                                           
113:                   *                                                                                                                                           
114:                                                                                                                   *                                           
115:                                                                                                                    **                                         
116:                        **   ***       *  *                 *                                                         *                                        
117:                                                                                                                      ***                                      
118:                         ***  *             *               *                                                                                                  
119:                         ***  *             *               *                                                                                                  
120:                 *                                          *                                                                                                  
121:                                       **                                             *                                   *    *                               
122:                                       **    *                                        *         *                          **                                  
123:                                        *         *                                             *                            *                                 
124:                                        *                                                                                                                      
125:                                                                                                                                                               
126:                                        *         *                                                                       *  *                                 
127:                                                                             *               *                                                                 
128:                                                                                                                                                               
129:                                                                                                                                                               
130:                                                                                                                                   **                          
131:                                                                                                          *                                                    
132:                                                                     *    *                                                       *                            
133:                                                                             *               *                                    *                            
134:                                                                   *                                                                                           
135:                                                                            *                  *                                  *                            
136:                                                                                                                                                               
137:                                                                                                                                                       *       
138:                                                                                                                                           *                   
139:                                                                                                                                                               
140:                                         *        *                                                                                                            
141:                                                                            *                                                                       *          
142:                                                                                             *                                               * *               
143:                                                                            *                                                                        *         
144:                                                                                                                                                               
145:                                                           *                                 *                                                    *   *        
146:                                                                                                                                             *     *           
147:                                                                                                                                  *                            
148:                                                                                                                                  *                            
149:                 *                                                                                                                                             
150:                                                                                                                                                       **      
151:                                                                   *                                                                                           
152:                    *                       *                                                                                                            **    
153:                                                                                                                                                            *  
154:                                                                                                                                                               
155:                        *                                                            *                                                                         
156:                                                                                                                                                             **
157:                                                           *                                                                                                   
DERIVES-IN-MANY RELATION
  0:  *************************************************************************************************************************************************************
  1:  *************************************************************************************************************************************************************
  2:  *************************************************************************************************************************************************************
  3:                                                                                                                                                               
  4:                                                                                                                                                               
  5:                                                                                                                                                               
  6:      *    *    ***** ****** **********************************************************************************************************************************
  7:      *    *    ***** ****** *****     **** **   **************************************************************************************************************
  8:      *    * ******** ************     **** **   **************************************************************************************************************
  9:                     *                                                                                                                                         
 10:           *                                                                                                                                                   
 11:                                                                                                                                                               
 12:      *    *  ******* ****** *****     **** **   **************************************************************************************************************
 13:      *    *  ******* ****** *****     **** **   **************************************************************************************************************
 14:      *    *    ***** ****** *****     **** **   **************************************************************************************************************
 15:                *                                                                                                                                              
 16:                                                                                                                                                               
 17:                                                                                                                                                               
 18:      *    *    ***** ****** *****     **** **   **************************************************************************************************************
 19:      *    *    ***** ****** *****     **** **   **************************************************************************************************************
 20:                     *                                                                                                                                         
 21:      *    *    ***** ****** *****     **** **   **************************************************************************************************************
 22:                * *                                                                                                                                            
 23:      *    *    ***** ****** *****     **** **   **************************************************************************************************************
 24:      *    *    ***** ****** *****     **** **   **************************************************************************************************************
 25:      *    *                                                                                                                                                   
 26:                                                                                                        **                                                     
 27:                                                                                                                                                               
 28:      *    *    ***** ****** *****     **** **   **************************************************************************************************************
 29:      *    *    ***** ****** *****     **** **   **************************************************************************************************************
 30:                               *                                                                                                                               
 31:      *    *    ***** ****** *****     **** **   **************************************************************************************************************
 32:      *    *    ***** ****** *****     **** **   **************************************************************************************************************
 33:      *    *    ***** ****** *****     **** **   **************************************************************************************************************
 34:      *    *    ***** ****** *****     **** *******************************************************************************************************************
 35:      *    *    ***** ****** *****     **** **   **************************************************************************************************************
 36:      *    *    ***** ****** *****     *******   **************************************************************************************************************
 37:                                                                                                                                                               
 38:      *    *    ***** ****** *****     **** **   **************************************************************************************************************
 39:                                        *                                                                                                                      
 40:      *    *    ***** ****** *****     **** **   **************************************************************************************************************
 41:      *    *    ***** ****** *****     **** **   **************************************************************************************************************
 42:                                                                                                                                                               
 43:      *    *    ***** ****** *****     **** **   **************************************************************************************************************
 44:      *    *    ***** ****** *****     **** **   **************************************************************************************************************
 45:                                                                                                                                                               
 46:      *    *    ***** ****** *****     **** ** ****************************************************************************************************************
 47:      *    *    ***** ****** *****     **** **   **************************************************************************************************************
 48:      *    *    ***** ****** *****     **** **   **************************************************************************************************************
 49:      *    *    ***** ****** *****     **** **   **************************************************************************************************************
 50:      *    *    ***** ****** *****     **** **   **************************************************************************************************************
 51:      *    *    ***** ****** *****     **** **   **************************************************************************************************************
 52:      *    *    ***** ****** *****     **** **   **************************************************************************************************************
 53:                                                                                                                                                               
 54:      *    *    ***** ****** *****     **** **   **************************************************************************************************************
 55:      *    *    ***** ****** *****     **** **   **************************************************************************************************************
 56:                                                                                                                                                               
 57:      *    *    ***** ****** *****     **** **   **************************************************************************************************************
 58:      *    *    ***** ****** *****     **** **   **************************************************************************************************************
 59:      *    *    ***** ****** *****     **** **   **************************************************************************************************************
 60:      *    *    ***** ****** *****     **** **   **************************************************************************************************************
 61:      *    *    ***** ****** *****     **** **   **************************************************************************************************************
 62:                                                                                                                                                               
 63:      *    *    ***** ****** *****     **** **   **************************************************************************************************************
 64:      *    *    ***** ****** *****     **** **   **************************************************************************************************************
 65:                                                                                                                                                               
 66:      *    *    ***** ****** *****     **** **   **************************************************************************************************************
 67:      *    *    ***** ****** *****     **** **   **************************************************************************************************************
 68:      *    *    ***** ****** *****     **** **   **************************************************************************************************************
 69:      *    *    ***** ****** *****     **** **   **************************************************************************************************************
 70:      *    *    ***** ****** *****     **** **   **************************************************************************************************************
 71:      *    *    ***** ****** *****     **** **   **************************************************************************************************************
 72:                                                                                                                                                               
 73:      *    *    ***** ****** *****     **** **   **************************************************************************************************************
 74:                 *                                                                                        *                        **                          
 75:      *    *    ***** ****** *****     **** **   **************************************************************************************************************
 76:      *    *    ***** ****** *****     **** **   **************************************************************************************************************
 77:      *    *    ***** ****** *****     **** **   **************************************************************************************************************
 78:      *    *    ***** ****** *****     **** **   **************************************************************************************************************
 79:      *    *    ***** ****** *****     **** **   **************************************************************************************************************
 80:      *    *    ***** ****** *****     **** **   **************************************************************************************************************
 81:                                                                                                                                                               
 82:      *    *    ***** ****** *****     **** **   **************************************************************************************************************
 83:      *    *    ***** ****** *****     **** **   **************************************************************************************************************
 84:      *    *    ***** ****** *****     **** **   **************************************************************************************************************
 85:      *    *    ***** ****** *****     **** **   **************************************************************************************************************
 86:                                                                                       *                                                                       
 87:                                                                                        *                                                                      
 88:      *    *    ***** ****** *****     **** **   **************************************************************************************************************
 89:                                                                                                                                                               
 90:      *    *    ***** ****** *****     **** **   **************************************************************************************************************
 91:      *    *    ***** ****** *****     **** **   **************************************************************************************************************
 92:      *    *    ***** ****** *****     **** **   **************************************************************************************************************
 93:      *    *    ***** ****** *****     **** **   **************************************************************************************************************
 94:      *    *    ***** ****** *****     **** **   **************************************************************************************************************
 95:      *    *    ***** ****** *****     **** **   **************************************************************************************************************
 96:      *    *    ***** ****** *****     **** **   **************************************************************************************************************
 97:      *    *    ***** ****** *****     **** **   **************************************************************************************************************
 98:      *    *    ***** ****** *****     **** **   **************************************************************************************************************
 99:      *    *    ***** ****** *****     **** **   **************************************************************************************************************
100:      *    *    ***** ****** *****     **** **   **************************************************************************************************************
101:      *    *    ***** ****** *****     **** **   **************************************************************************************************************
102:      *    *    ***** ****** *****     **** **   **************************************************************************************************************
103:                                                                                                        **                                                     
104:                                                                                                                                                               
105:                 *                                                                                        *                                                    
106:      *    *    ***** ****** *****     **** **   **************************************************************************************************************
107:                                                                                                                                                               
108:      *    *    ***** ****** *****     **** **   **************************************************************************************************************
109:      *    *    ***** ****** *****     **** **   **************************************************************************************************************
110:                *                                                                                                                                              
111:      *    *    ***** ****** *****     **** **   **************************************************************************************************************
112:      *    *    ***** ****** *****     **** **   **************************************************************************************************************
113:      *    *    ***** ****** *****     **** **   **************************************************************************************************************
114:                                                                                                                   *                                           
115:      *    *    ***** ****** *****     **** **   **************************************************************************************************************
116:      *    *    ***** ****** *****     **** **   **************************************************************************************************************
117:      *    *    ***** ****** *****     **** **   **************************************************************************************************************
118:      *    *    ***** ****** *****     **** **   **************************************************************************************************************
119:      *    *    ***** ****** *****     **** **   **************************************************************************************************************
120:      *    *    ***** ****** *****     **** **   **************************************************************************************************************
121:      *    *    ***** ****** *****     **** **   **************************************************************************************************************
122:      *    *    ***** ****** *****     **** **   **************************************************************************************************************
123:      *    *    ***** ****** *****     **** **   **************************************************************************************************************
124:                                        *                                                                                                                      
125:                                                                                                                                                               
126:      *    *    ***** ****** *****     **** **   **************************************************************************************************************
127:      *    *    ***** ****** *****     **** **   **************************************************************************************************************
128:                                                                                                                                                               
129:                                                                                                                                                               
130:                 *                                                                                        *                        **                          
131:                 *                                                                                        *                                                    
132:      *    *    ***** ****** *****     **** **   **************************************************************************************************************
133:      *    *    ***** ****** *****     **** **   **************************************************************************************************************
134:      *    *    ***** ****** *****     **** **   **************************************************************************************************************
135:      *    *    ***** ****** *****     **** **   **************************************************************************************************************
136:                                                                                                                                                               
137:      *    *    ***** ****** *****     **** **   **************************************************************************************************************
138:                                                                                                                                           *                   
139:                                                                                                                                                               
140:      *    *    ***** ****** *****     **** **   **************************************************************************************************************
141:      *    *    ***** ****** *****     **** **   **************************************************************************************************************
142:      *    *    ***** ****** *****     **** **   **************************************************************************************************************
143:      *    *    ***** ****** *****     **** **   **************************************************************************************************************
144:                                                                                                                                                               
145:      *    *    ***** ****** *****     **** **   **************************************************************************************************************
146:      *    *    ***** ****** *****     **** **   **************************************************************************************************************
147:                                                                                                                                  *                            
148:                                                                                                                                  *                            
149:                 *                                                                                                                                             
150:      *    *    ***** ****** *****     **** **   **************************************************************************************************************
151:      *    *    ***** ****** *****     **** **   **************************************************************************************************************
152:      *    *    ***** ****** *****     **** **   **************************************************************************************************************
153:      *    *    ***** ****** *****     **** **   **************************************************************************************************************
154:                                                                                                                                                               
155:      *    *    ***** ****** *****     **** **   **************************************************************************************************************
156:      *    *    ***** ****** *****     **** **   **************************************************************************************************************
157:      *    *    ***** ****** *****     **** **   **************************************************************************************************************
Fenton impurity is: 0.896588
>>> Fenton closed impurity is: 58.688
Class #1: (size = 2) 
	extdefs	extdef
Class #17: (size = 94) 
	base_class.1	parm	named_class_head_sans_basetype	notype_declarator	maybe_raises	typed_declspecs	declarator
	notype_initdecls	initdecls	parmlist	scoped_typename	fn.def2	init	nonnull_exprlist
	template_type_name	id_scope	identifier_or_opname	operator_name	template_type	template_instantiation	template_arg_list
	template_arg	typename	expr_no_commas	template_instantiate_once	maybe_base_class_list	opt.component_decl_list	template_instantiate_some
	expr	paren_expr_or_null	paren_cond_or_null	condition	xcond	typed_typespecs	partially_scoped_stmt
	stmts	simple_stmt	already_scoped_stmt	unary_expr	primary	cast_expr	new
	typespec	absdcl	nonmomentary_expr	initlist	xexpr	object_star	compstmt
	object	decl	after_type_declarator	reserved_declspecs	typespecqual_reserved	reserved_typespecquals	structsp
	initdcl0	initdcl	notype_initdcl0	enumlist	class_head	named_class_head	base_class_list
	base_class	scoped_base_class	component_decl_list	component_decl	components	component_declarator0	component_declarator
	enumerator	absdcl1	after_type_declarator_no_typename	after_type_member_declarator	abs_member_declarator	stmt	simple_if
	implicitly_scoped_stmt	forhead.1	forhead.2	asm_operands	raise_identifier	try	except_stmts
	ansi_try	ansi_except_stmts	raise_identifiers	nonnull_asm_operands	asm_operand	parms	bad_parm
	abs_or_notype_decl	ansi_raise_identifiers	ansi_raise_identifier
>>> There are 64 equivalence classes, 2 of which are non-singleton
As a percentage of the number of non-terminals, there are 40.5% equivalence classes 
>>> (Depth) Largest equivalence class has 94 non-terminals
Varju height metric is: 18.8
EQUIVALENCE GRAPH (size 64)
0:  ***************************************************************
1:   **************************************************************
2:                                                                 
3:                                                                 
4:                                                                 
5:     *    *    **** *** *****************************************
6:     *    *    **** *** *     *    ******************************
7:     *    * ******* *****     *    ******************************
8:                   *                                             
9:                                                                 
10:                                                                 
11:     *    *  ****** *** *     *    ******************************
12:     *    *   ***** *** *     *    ******************************
13:     *    *    **** *** *     *    ******************************
14:                                                                 
15:                                                                 
16:                                                                 
17:     *    *    ***  *** *     *    ******************************
18:                                                                 
19:               * *                                               
20:     *    *                                                      
21:                                             **                  
22:                                                                 
23:                                                                 
24:     *    *    **** *** *     *    ******************************
25:     *    *    **** *** *     * *********************************
26:     *    *    **** *** *     *    ******************************
27:     *    *    **** *** *     **   ******************************
28:                                                                 
29:                                                                 
30:                                                                 
31:                                                                 
32:     *    *    **** *** *     *   *******************************
33:     *    *    **** *** *     *    ******************************
34:                                                                 
35:                                                                 
36:                                                                 
37:                                                                 
38:                                                                 
39:                *                              *       **        
40:                                                                 
41:                                                                 
42:                                                                 
43:                                                                 
44:                                              *                  
45:                                                                 
46:                *                                                
47:                                                                 
48:               *                                                 
49:                                                                 
50:                              *                                  
51:                                                                 
52:                                                                 
53:                                                                 
54:                *                              *        *        
55:                *                              *                 
56:                                                                 
57:                                                                 
58:                                                                 
59:                                                                 
60:                                                      *          
61:                                                      *          
62:                *                                                
63:                                                                 
